###########
#        O#
#   P   ###
#         #
#######   #
#    ##   #
#    ##   #
#         #
#      XX #
#      #  #
###########
