#########################
#        O             O#
#   P             X     #
#                       #
#######                 #
#  O ##        X        #
#    ##            O    #
#                       #
#      XX         X     #
#      #               O#
#########################
